# Wall and floor
#  0   1   2   3   4   5   6   7   8   9   a   b   c   d   e   f
 000 000 000 000 000 000 000 000 000 000 000 000 000 000 000 000
 000 000 000 000 000 000 000 000 000 000 000 000 000 000 000 000
 000 000 000 000 000 000 000 000 000 000 000 000 000 000 000 000
 000 000 000 000 000 000 000 000 000 000 000 000 000 000 000 000
 000 000 000 000 000 000 000 000 000 000 000 000 000 000 000 000
 000 000 000 000 000 000 000 000 000 000 000 000 000 000 000 000
 000 000 000 000 000 000 000 000 000 000 000 000 000 000 000 000
 501 502 500 501 501 501 502 500 501 501 501 502 500 501 501 501
 541 542 540 541 541 541 542 540 541 541 541 542 540 541 541 541
 541 542 540 541 541 541 542 540 541 541 541 542 540 541 541 541
 581 582 580 581 581 581 582 580 581 581 581 582 580 581 581 581
 4c5 4c5 4c5 4c5 4c5 4c5 4c5 4c5 4c5 4c5 4c5 4c5 4c5 4c5 4c5 4c5
