#  0   1   2   3   4   5   6   7   8   9   a   b   c   d   e   f
 4e0 4e1 4e1 4e1 4e1 4e1 4e1 4e1 4e1 4e1 4e1 4e1 4e1 4e1 4e1 4e2
 520 521 541 541 541 521 521 521 521 521 521 521 521 521 521 522
 520 521 541 541 541 521 521 521 521 541 541 541 541 541 521 522
 520 521 541 541 541 521 521 521 521 541 541 541 541 541 521 522
 520 521 521 521 521 521 521 521 521 541 541 541 541 541 521 522
 520 521 521 546 546 546 546 521 521 541 541 541 541 541 521 522
 520 521 521 546 546 546 546 521 521 541 541 541 541 541 521 522
 520 521 521 546 546 546 546 521 521 521 521 521 521 521 521 522
 520 521 521 521 521 521 521 521 521 521 521 521 521 521 521 522
 520 521 521 521 521 521 521 521 521 521 521 521 521 521 521 522
 560 561 561 561 561 561 561 561 561 561 561 561 561 561 561 562
 4c5 4c5 4c5 4c5 4c5 4c5 4c5 4c5 4c5 4c5 4c5 4c5 4c5 4c5 4c5 4c5
